i   jekyll                                                                                                                                                 - Simple, blog aware, static site generator                                                                                                                        
p   ruby-jekyll-archives                                                                                                                                   - Jekyll plugin to generate post archive pages                                                                                                                     
i   ruby-jekyll-avatar                                                                                                                                     - Jekyll plugin for rendering GitHub avatars                                                                                                                       
p   ruby-jekyll-coffeescript                                                                                                                               - CoffeeScript converter for Jekyll                                                                                                                                
p   ruby-jekyll-commonmark                                                                                                                                 - commonmark markdown converter for jekyll                                                                                                                         
p   ruby-jekyll-compose                                                                                                                                    - Jekyll plugin to create content from the command line                                                                                                            
p   ruby-jekyll-data                                                                                                                                       - read and add data files within Jekyll theme-gems to site hash                                                                                                    
p   ruby-jekyll-default-layout                                                                                                                             - plugin to set default layouts for Jekyll pages and posts                                                                                                         
p   ruby-jekyll-feed                                                                                                                                       - Atom feed generator for Jekyll                                                                                                                                   
p   ruby-jekyll-gist                                                                                                                                       - Liquid tag for displaying GitHub Gists in Jekyll sites                                                                                                           
p   ruby-jekyll-github-metadata                                                                                                                            - Jekyll plugin to propagate the site.github namespace                                                                                                             
p   ruby-jekyll-include-cache                                                                                                                              - Jekyll plugin to cache the rendering of Liquid includes                                                                                                          
p   ruby-jekyll-last-modified-at                                                                                                                           - indicate the last time a file was modified                                                                                                                       
p   ruby-jekyll-mentions                                                                                                                                   - Jekyll plugin to add mentionable link support                                                                                                                    
p   ruby-jekyll-multiple-languages                                                                                                                         - Jekyll plugin to internationalize sites                                                                                                                          
p   ruby-jekyll-optional-front-matter                                                                                                                      - jekyll plugin to make front matter optional for markdown files                                                                                                   
p   ruby-jekyll-paginate                                                                                                                                   - Default pagination generator for Jekyll                                                                                                                          
p   ruby-jekyll-paginate-v2                                                                                                                                - enhanced pagination generator for Jekyll 3                                                                                                                       
p   ruby-jekyll-readme-index                                                                                                                               - plugin for building Jekyll sites with any GitHub-hosted theme                                                                                                    
p   ruby-jekyll-redirect-from                                                                                                                              - Jekyll plugin to give posts and pages multiple URLs                                                                                                              
p   ruby-jekyll-relative-links                                                                                                                             - plugin for Jekyll to convert relative links to Markdown files                                                                                                    
p   ruby-jekyll-remote-theme                                                                                                                               - plugin for building Jekyll sites with any GitHub-hosted theme                                                                                                    
i A ruby-jekyll-sass-converter                                                                                                                             - Basic Sass converter for Jekyll                                                                                                                                  
p   ruby-jekyll-seo-tag                                                                                                                                    - Jekyll plugin to add metadata tags                                                                                                                               
p   ruby-jekyll-sitemap                                                                                                                                    - Jekyll plugin to silently generate a sitemap                                                                                                                     
p   ruby-jekyll-test-plugin                                                                                                                                - facility to test Jekyll plugins                                                                                                                                  
p   ruby-jekyll-test-plugin-malicious                                                                                                                      - Malicious test plugin for Jekyll                                                                                                                                 
p   ruby-jekyll-titles-from-headings                                                                                                                       - jekyll plugin to create a page title from the markdown heading                                                                                                   
p   ruby-jekyll-toc                                                                                                                                        - Jekyll plugin to generate a table of contents                                                                                                                    
i A ruby-jekyll-watch                                                                                                                                      - Rebuild your Jekyll site when a file changes                                                                                                                     
